20 10
####################
###     ####     ###
###     ####     ###
###     ####     ###
####################
  ################  
   ##############   
#                  #
#####          #####
####################
