8 5
########
#   E  #
#   E  #
#    #E#
########
1 1 2
3
2 1 1
2 2 1
3 2 1
