8 9
  ##### 
###   # 
#E    # 
###  E#
#E##  #
# # E ##
#  E  E#
#   E  #
########
2 2 1
7
3 2 1
4 3 1
4 4 1
1 6 1
3 6 1
4 6 1
5 6 1
